11111111111111111111
10000000000000000001
10111111000011111101
10100000000000000101
10101011111111010101
10100000000000000101
10100111111111100101
10000000000000000001
10001111100111110001
10000000000000000001
10000000000000000001
10001111100111110001
10000000000000000001
10100111111111100101
10100000000000000101
10101011111111010101
10100000000000000101
10111111000011111101
10000000000000000001
11111111111111111111
