11111111111111111111
10002222220022222221
10121012121012121201
12222222222222202221
12121210121212121021
10222222222222222001
12121212101210121221
12222220002222222021
12121210121210121201
12222220202222020221
12222222220022202201
12121012101212121221
12222222220222222221
12121212101012121221
12222222222222222201
10121212121212121201
12222222222222202021
12121212121210121201
12222222222222200001
11111111111111111111
